XXXXXXXXXXXXXXXXXXXXXXXXXXXXXXXXXXXXXXXXXXXX
XX--XX------------XXXXXXX--XX------------XXX
XX-XXXXXXXXXXXXXX-XXXXXXX-XXXXXXXXXXXXXX-XXX
XX-XXXXXXXXXXXXXX-XXXXXXX-XXXXXXXXXXXXXX-XXX
XX-XXXXXXXXXXXXXX-XXXXXXX-XXXXXXXXXXXXXX-XXX
XX-XXXXXXXXXXXXXX-XXXXXXX-XXXXXXXXXXXXXX-XXX
XX-XXXXXXXXXXXXXX-XXXXXXX-XXXXXXXXXXXXXX-XXX
XX-XXXXXXXXXXXXXX-XXXXXXX-XXXXXXXXXXXXXX-XXX
XX-XXXXXXXXXXXXXX-XXXXXXX-XXXXXXXXXXXXXX-XXX
XX-XXXXXXXXXXXXXX-XXXXXXX-XXXXXXXXXXXXXX-XXX
XX-XXXXXXXXXXXXXX-XXXXXXX-XXXXXXXXXXXXXX-XXX
XX-XXXXXXXXXXXXXX-XXXXXXX-XXXXXXXXXXXXXX-XXX
XX-XXXXXXXXXXXXXX-XXXXXXX-XXXXXXXXXXXXXX-XXX
XX-XXXXXXXXXXXXXX-XXXXXXX-XXXXXXXXXXXXXX-XXX
XX-XXXXXXXXXXXXXX-XXXXXXX-XXXXXXXXXXXXXX-XXX
XX-XXXXXXXXXXXXXX-XXXXXXX-XXXXXXXXXXXXXX-XXX
XX-XXXXXXXXXXXXXX-XXXXXXX-XXXXXXXXXXXXXX-XXX
XX-XXXXXXXXXXXXXX-XXXXXXX-XXXXXXXXXXXXXX-XXX
XX-XXXXXXXXXXXXXX-XXXXXXX-XXXXXXXXXXXXXX-XXX
XX--------XXX-----XXXXXXX--------XXX-----XXX
XXXXXXXXXXXXXXXXXXXXXXXXXXXXXXXXXXXXXXXXXXXX
XXXXXXXXXXXXXXXXXXXXXXXXXXXXXXXXXXXXXXXXXXXX
XXXXXXXXXXXXXXXXXXXXXXXXXXXXXXXXXXXXXXXXXXXX
XXXXXXXXXXXXXXXXXXXXXXXXXXXXXXXXXXXXXXXXXXXX
XX--XX------------XXXXXXX--XX------------XXX
XX-XXXXXXXXXXXXXX-XXXXXXX-XXXXXXXXXXXXXX-XXX
XX-XXXXXXXXXXXXXX-XXXXXXX-XXXXXXXXXXXXXX-XXX
XX-XXXXXXXXXXXXXX-XXXXXXX-XXXXXXXXXXXXXX-XXX
XX-XXXXXXXXXXXXXX-XXXXXXX-XXXXXXXXXXXXXX-XXX
XX-XXXXXXXXXXXXXX-XXXXXXX-XXXXXXXXXXXXXX-XXX
XX-XXXXXXXXXXXXXX-XXXXXXX-XXXXXXXXXXXXXX-XXX
XX-XXXXXXXXXXXXXX-XXXXXXX-XXXXXXXXXXXXXX-XXX
XX-XXXXXXXXXXXXXX-XXXXXXX-XXXXXXXXXXXXXX-XXX
XX-XXXXXXXXXXXXXX-XXXXXXX-XXXXXXXXXXXXXX-XXX
XX-XXXXXXXXXXXXXX-XXXXXXX-XXXXXXXXXXXXXX-XXX
XX-XXXXXXXXXXXXXX-XXXXXXX-XXXXXXXXXXXXXX-XXX
XX-XXXXXXXXXXXXXX-XXXXXXX-XXXXXXXXXXXXXX-XXX
XX-XXXXXXXXXXXXXX-XXXXXXX-XXXXXXXXXXXXXX-XXX
XX-XXXXXXXXXXXXXX-XXXXXXX-XXXXXXXXXXXXXX-XXX
XX-XXXXXXXXXXXXXX-XXXXXXX-XXXXXXXXXXXXXX-XXX
XX-XXXXXXXXXXXXXX-XXXXXXX-XXXXXXXXXXXXXX-XXX
XX-XXXXXXXXXXXXXX-XXXXXXX-XXXXXXXXXXXXXX-XXX
XX--------XXX-----XXXXXXX--------XXX-----XXX
XXXXXXXXXXXXXXXXXXXXXXXXXXXXXXXXXXXXXXXXXXXX
XXXXXXXXXXXXXXXXXXXXXXXXXXXXXXXXXXXXXXXXXXXX
XXXXXXXXXXXXXXXXXXXXXXXXXXXXXXXXXXXXXXXXXXXX
