XXXXXXXXXXXXXXXXXXXXX
XX--XX------------XXX
XX-XXXXXXXXXXXXXX-XXX
XX-XXXXXXXXXXXXXX-XXX
XX-XXXXXXXXXXXXXX-XXX
XX-XXXXXXXXXXXXXX-XXX
XX-XXXXXXXXXXXXXX-XXX
XX-XXXXXXXXXXXXXX-XXX
XX-XXXXXXXXXXXXXX-XXX
XX-XXXXXXXXXXXXXX-XXX
XX-XXXXXXXXXXXXXX-XXX
XX-XXXXXXXXXXXXXX-XXX
XX-XXXXXXXXXXXXXX-XXX
XX-XXXXXXXXXXXXXX-XXX
XX-XXXXXXXXXXXXXX-XXX
XX-XXXXXXXXXXXXXX-XXX
XX-XXXXXXXXXXXXXX-XXX
XX-XXXXXXXXXXXXXX-XXX
XX-XXXXXXXXXXXXXX-XXX
XX----------------XXX
XXXXXXXXXXXXXXXXXXXXX
XXXXXXXXXXXXXXXXXXXXX
XXXXXXXXXXXXXXXXXXXXX
