XXXXXXXXXXXXXXXXXXXXXXXXX
XXXXXXXXXXXXXXXXXXXXXXXXX
XXXXXXXXXXXXXXXXXXXXXXXXX
XXX-----X-----XXXXXXXXXXX
XXX-XXXXXXXXX-XXXXXXXXXXX
XXX-XXXXXXXXX-XXXXXXXXXXX
XXX-XXXXXXXXX-XXXXXXXXXXX
XXX-XXXXXXXXX-XXXXXXXXXXX
XXX-XXXXXXXXX-XXXXXXXXXXX
XXX-XXXXXXXXX-XXXXXXXXXXX
XXX-XXXXXXXXX-XXXXXXXXXXX
XXX-XXXXXXXXX-XXXXXXXXXXX
XXX-XXXXXXXXX-XXXXXXXXXXX
XXX-XXXXXXXXX-XXXXXXXXXXX
XXX-----XX----XXXXXXXXXXX
XXXXXXXXXXXXXXXXXXXXXXXXX
XXXXXXXXXXXXXXXXXXXXXXXXX
XXXXXXXXXXXXXXXXXXXXXXXXX
XXXXXXXXXXXXXXXXXXXXXXXXX
XXXXXX--XX------------XXX
XXXXXX-XXXXXXXXXXXXXX-XXX
XXXXXX-XXXXXXXXXXXXXX-XXX
XXXXXX-XXXXXXXXXXXXXX-XXX
XXXXXX-XXXXXXXXXXXXXX-XXX
XXXXXX-XXXXXXXXXXXXXX-XXX
XXXXXX-XXXXXXXXXXXXXX-XXX
XXXXXX-XXXXXXXXXXXXXX-XXX
XXXXXX-XXXXXXXXXXXXXX-XXX
XXXXXX-XXXXXXXXXXXXXX-XXX
XXXXXX-XXXXXXXXXXXXXX-XXX
XXXXXX-XXXXXXXXXXXXXX-XXX
XXXXXX-XXXXXXXXXXXXXX-XXX
XXXXXX-XXXXXXXXXXXXXX-XXX
XXXXXX-XXXXXXXXXXXXXX-XXX
XXXXXX-XXXXXXXXXXXXXX-XXX
XXXXXX-XXXXXXXXXXXXXX-XXX
XXXXXX-XXXXXXXXXXXXXX-XXX
XXXXXX----------------XXX
XXXXXXXXXXXXXXXXXXXXXXXXX
XXXXXXXXXXXXXXXXXXXXXXXXX
XXXXXXXXXXXXXXXXXXXXXXXXX
