XXXXXXXXXXXXXXXXXXXXXXX
XXXXXXXXXXXXXXXXXXXXXXX
XXXXXXXXXXXXXXXXXXXXXXX
XXX------XX----XXXXXXXX
XXX-XXXXXXXXXX-XXXXXXXX
XXX-XXXXXXXXXX-XXXXXXXX
XXX-XXXXXXXXXX-XXXXXXXX
XXX-XXXXXXXXXX-XXXXXXXX
XXX-XXXXXXXXXX-XXXXXXXX
XXX-XXXXXXXXXX-XXXXXXXX
XXX-XXXXXXXXXX-XXXXXXXX
XXX-XXXXXXXXXX-XXXXXXXX
XXX-XXXXXXXXXX-XXXXXXXX
XXX-XXXXXXXXXX-XXXXXXXX
XXX------X-----XXXXXXXX
XXXXXXXXXXXXXXXXXXXXXXX
XXXXXXXXXXXXXXXXXXXXXXX
XXXXXXXXXXXXXXXXXXXXXXX
XXXXXXXXXXXXXXXXXXXXXXX
XXXXXXX--XXX--------XXX
XXXXXXX-XXXXXXXXXXX-XXX
XXXXXXX-XXXXXXXXXXX-XXX
XXXXXXX-XXXXXXXXXXX-XXX
XXXXXXX-XXXXXXXXXXX-XXX
XXXXXXX-XXXXXXXXXXX-XXX
XXXXXXX-XXXXXXXXXXX-XXX
XXXXXXX-XXXXXXXXXXX-XXX
XXXXXXX-XXXXXXXXXXX-XXX
XXXXXXX-XXXXXXXXXXX-XXX
XXXXXXX-XXXXXXXXXXX-XXX
XXXXXXX-XXXXXXXXXXX-XXX
XXXXXXX-XXXXXXXXXXX-XXX
XXXXXXX-XXXXXXXXXXX-XXX
XXXXXXX-------------XXX
XXXXXXXXXXXXXXXXXXXXXXX
XXXXXXXXXXXXXXXXXXXXXXX
XXXXXXXXXXXXXXXXXXXXXXX
XXXXXXXXXXXXXX----XXXXX
XXXXXXXXXXXXXXXXXXXXXXX
XXXXXXXXXXXXXXXXXXXXXXX
XXXXXXXXXXXXXXXXXXXXXXX
