XXXXXXXXXXXXXXXXXXXXXXXXXXXXXXXXXXXXXXXXXX
XXXXXXXXXXXXXXXXXXXXXXXXXXXXXXXXXXXXXXXXXX
XXXXXXXXXXXXXXXXXXXXXXXXXXXXXXXXXXXXXXXXXX
XXX--------------XXXXXXXX--------------XXX
XXX-XXXXXXXXXXXX-XXXXXXXX-XXXXXXXXXXXX-XXX
XXX-XXXXXXXXXXXX-XXXXXXXX-XXXXXXXXXXXX-XXX
XXX-XXXXXXXXXXXX---XXXX---XXXXXXXXXXXX-XXX
XXX-XXXXXXXXXXXXXXXXXXXXXXXXXXXXXXXXXX-XXX
XXX-XXXXXXXXXXXXXXXXXXXXXXXXXXXXXXXXXX-XXX
XXX-XXXXXXXXXXXXXXXXXXXXXXXXXXXXXXXXXX-XXX
XXX-XXXXXXXXXXXXXXXXXXXXXXXXXXXXXXXXXX-XXX
XXX-XXXXXXXXXXXXXXXXXXXXXXXXXXXXXXXXXX-XXX
XXX-XXXXXXXXXXXXXXXXXXXXXXXXXXXXXXXXXX-XXX
XXX-XXXXXXXXXXXXXXXXXXXXXXXXXXXXXXXXXX-XXX
XXX-XXXXXXXXXXXXXXXXXXXXXXXXXXXXXXXXXX-XXX
XXX-XXXXXXXXXXXXXXXXXXXXXXXXXXXXXXXXXX-XXX
XXX-XXXXXXXXXXXXXXXXXXXXXXXXXXXXXXXXXX-XXX
XXX-XXXXXXXXXXXXXXXXXXXXXXXXXXXXXXXXXX-XXX
XXX-XXXXXXXXXXXXXXXXXXXXXXXXXXXXXXXXXX-XXX
XXX-XXXXXXXXXXXXXXXXXXXXXXXXXXXXXXXXXX-XXX
XXX-XXXXXXXXXXXXXXXXXXXXXXXXXXXXXXXXXX-XXX
XXX-XXXXXXXXXXXXXXXXXXXXXXXXXXXXXXXXXX-XXX
XXX-XXXXXXXXXXXXXXXXXXXXXXXXXXXXXXXXXX-XXX
XXX-XXXXXXXXXXXXXXXXXXXXXXXXXXXXXXXXXX-XXX
XXX-XXXXXXXXXXXXXXXXXXXXXXXXXXXXXXXXXX-XXX
XXX-XXXXXXXXXXXXXXXXXXXXXXXXXXXXXXXXXX-XXX
XXX-XXXXXXXXXXXXXXXXXXXXXXXXXXXXXXXXXX-XXX
XXX-XXXXXXXXXXXXXXXXXXXXXXXXXXXXXXXXXX-XXX
XXX-XXXXXXXXXXXXXXXXXXXXXXXXXXXXXXXXXX-XXX
XXX-XXXXXXXXXXXXXXXXXXXXXXXXXXXXXXXXXX-XXX
XXX-XXXXXXXXXXXXXXXXXXXXXXXXXXXXXXXXXX-XXX
XXX-XXXXXXXXXXXXXXXXXXXXXXXXXXXXXXXXXX-XXX
XXX-XXXXXXXXXXXXXXXXXXXXXXXXXXXXXXXXXX-XXX
XXX-XXXXXXXXXXXXXXXXXXXXXXXXXXXXXXXXXX-XXX
XXX-XXXXXXXXXXXXXXXXXXXXXXXXXXXXXXXXXX-XXX
XXX-XXXXXXXXXXXXXXXXXXXXXXXXXXXXXXXXXX-XXX
XXX-XXXXXXXXXXXXXXXXXXXXXXXXXXXXXXXXXX-XXX
XXX-XXXXXXXXXXXXXXXXXXXXXXXXXXXXXXXXXX-XXX
XXX-XXXXXXXXXXXXXXXXXXXXXXXXXXXXXXXXXX-XXX
XXX-XXXXXXXXXXXXXXXXXXXXXXXXXXXXXXXXXX-XXX
XXX-XXXXXXXXXXXXXXXXXXXXXXXXXXXXXXXXXX-XXX
XXX-XXXXXXXXXXXXXXXXXXXXXXXXXXXXXXXXXX-XXX
XXX-XXXXXXXXXXXXXXXXXXXXXXXXXXXXXXXXXX-XXX
XXX-XXXXXXXXXXXXXXXXXXXXXXXXXXXXXXXXXX-XXX
XXX-XXXXXXXXXXXXXXXXXXXXXXXXXXXXXXXXXX-XXX
XXX-XXXXXXXXXXXXXXXXXXXXXXXXXXXXXXXXXX-XXX
XXX-XXXXXXXXXXXX---XXXXX--XXXXXXXXXXXX-XXX
XXX-XXXXXXXXXXXX-XXXXXXXX-XXXXXXXXXXXX-XXX
XXX-XXXXXXXXXXXX-XXXXXXXX-XXXXXXXXXXXX-XXX
XXX--------------XXXXXXXX--------------XXX
XXXXXXXXXXXXXXXXXXXXXXXXXXXXXXXXXXXXXXXXXX
XXXXXXXXXXXXXXXXXXXXXXXXXXXXXXXXXXXXXXXXXX
XXXXXXXXXXXXXXXXXXXXXXXXXXXXXXXXXXXXXXXXXX
XXXXXXXXXXXXXXXXXXXXXXXXXXXXXXXXXXXXXXXXXX
XXXXXXXXXXXXX------XXXXX-----XXXXXXXXXXXXX
XXXXXXXXXXXXX-XXXXXXXXXXXXXX-XXXXXXXXXXXXX
XXXXXXXXXXXXX-XXXXXXXXXXXXXX-XXXXXXXXXXXXX
XXXXXXXXXXXXX-XXXXXXXXXXXXXX-XXXXXXXXXXXXX
XXXXXXXXXXXXX-XXXXXXXXXXXXXX-XXXXXXXXXXXXX
XXXXXXXXXXXXX-XXXXXXXXXXXXXX-XXXXXXXXXXXXX
XXXXXXXXXXXXX-XXXXXXXXXXXXXX-XXXXXXXXXXXXX
XXXXXXXXXXXXX-XXXXXXXXXXXXXX-XXXXXXXXXXXXX
XXXXXXXXXXXXX-XXXXXXXXXXXXXX-XXXXXXXXXXXXX
XXXXXXXXXXXXX-XXXXXXXXXXXXXX-XXXXXXXXXXXXX
XXXXXXXXXXXXX-XXXXXXXXXXXXXX-XXXXXXXXXXXXX
XXXXXXXXXXXXX-XXXXXXXXXXXXXX-XXXXXXXXXXXXX
XXXXXXXXXXXXX-XXXXXXXXXXXXXX-XXXXXXXXXXXXX
XXXXXXXXXXXXX-XXXXXXXXXXXXXX-XXXXXXXXXXXXX
XXXXXXXXXXXXX-XXXXXXXXXXXXXX-XXXXXXXXXXXXX
XXXXXXXXXXXXX----------------XXXXXXXXXXXXX
XXXXXXXXXXXXXXXXXXXXXXXXXXXXXXXXXXXXXXXXXX
XXXXXXXXXXXXXXXXXXXXXXXXXXXXXXXXXXXXXXXXXX
XXXXXXXXXXXXXXXXXXXXXXXXXXXXXXXXXXXXXXXXXX
